"lang"
{
"Language"	"czech"
"Tokens"
{
"NEW_ACHIEVEMENT_1_4_NAME"	"Záměrně umístěno na nedosažitelné plošině"
"[english]NEW_ACHIEVEMENT_1_4_NAME"	"Intentionally Out of Reach"
"NEW_ACHIEVEMENT_1_4_DESC"	"Získejte plně vylepšené příruční portálové zařízení společnosti Aperture Science."
"[english]NEW_ACHIEVEMENT_1_4_DESC"	"Acquire the fully powered Aperture Science Handheld Portal Device."
"NEW_ACHIEVEMENT_1_6_NAME"	"Dortová dieta"
"[english]NEW_ACHIEVEMENT_1_6_NAME"	"Aperture Diet"
"NEW_ACHIEVEMENT_1_6_DESC"	"Najděte všechny skryté dorty."
"[english]NEW_ACHIEVEMENT_1_6_DESC"	"Find all the secret cakes."
"NEW_ACHIEVEMENT_1_7_NAME"	"Zaměstnanec na plný úvazek"
"[english]NEW_ACHIEVEMENT_1_7_NAME"	"Full-Time Employee"
"NEW_ACHIEVEMENT_1_7_DESC"	"Dokončete hru Rexaura."
"[english]NEW_ACHIEVEMENT_1_7_DESC"	"Complete Rexaura."
"NEW_ACHIEVEMENT_1_8_NAME"	"Syndrom vnitřní mikrovlnné trouby"
"[english]NEW_ACHIEVEMENT_1_8_NAME"	"Minor Lung Explosions"
"NEW_ACHIEVEMENT_1_8_DESC"	"Nechte se zabít 1600megawattovou pozitronovou koulí."
"[english]NEW_ACHIEVEMENT_1_8_DESC"	"Be killed by a 1600 megawatt positron energy orb."
}
}
