"lang"
{
"Language"	"portuguese"
"Tokens"
{
"NEW_ACHIEVEMENT_1_4_NAME"	"Intencionalmente fora de alcance"
"[english]NEW_ACHIEVEMENT_1_4_NAME"	"Intentionally Out of Reach"
"NEW_ACHIEVEMENT_1_4_DESC"	"Obtém o Dispositivo Portátil de Portais da Aperture Science completo."
"[english]NEW_ACHIEVEMENT_1_4_DESC"	"Acquire the fully powered Aperture Science Handheld Portal Device."
"NEW_ACHIEVEMENT_1_6_NAME"	"Dieta da Aperture Science"
"[english]NEW_ACHIEVEMENT_1_6_NAME"	"Aperture Diet"
"NEW_ACHIEVEMENT_1_6_DESC"	"Encontra todos os bolos secretos."
"[english]NEW_ACHIEVEMENT_1_6_DESC"	"Find all the secret cakes."
"NEW_ACHIEVEMENT_1_7_NAME"	"Empregado a tempo inteiro"
"[english]NEW_ACHIEVEMENT_1_7_NAME"	"Full-Time Employee"
"NEW_ACHIEVEMENT_1_7_DESC"	"Conclui o Rexaura."
"[english]NEW_ACHIEVEMENT_1_7_DESC"	"Complete Rexaura."
"NEW_ACHIEVEMENT_1_8_NAME"	"Explosões ligeiras dos pulmões"
"[english]NEW_ACHIEVEMENT_1_8_NAME"	"Minor Lung Explosions"
"NEW_ACHIEVEMENT_1_8_DESC"	"Morre por causa de um globo de energia positrónica de 1600 megawatts."
"[english]NEW_ACHIEVEMENT_1_8_DESC"	"Be killed by a 1600 megawatt positron energy orb."
}
}
