"lang"
{
"Language"	"dutch"
"Tokens"
{
"NEW_ACHIEVEMENT_1_4_NAME"	"Opzettelijk buiten bereik"
"[english]NEW_ACHIEVEMENT_1_4_NAME"	"Intentionally Out of Reach"
"NEW_ACHIEVEMENT_1_4_DESC"	"Verwerf het volledig opgeladen Aperture Science handportaltoestel."
"[english]NEW_ACHIEVEMENT_1_4_DESC"	"Acquire the fully powered Aperture Science Handheld Portal Device."
"NEW_ACHIEVEMENT_1_6_NAME"	"Aperture-dieet"
"[english]NEW_ACHIEVEMENT_1_6_NAME"	"Aperture Diet"
"NEW_ACHIEVEMENT_1_6_DESC"	"Vind alle geheime taarten."
"[english]NEW_ACHIEVEMENT_1_6_DESC"	"Find all the secret cakes."
"NEW_ACHIEVEMENT_1_7_NAME"	"Voltijd medewerker"
"[english]NEW_ACHIEVEMENT_1_7_NAME"	"Full-Time Employee"
"NEW_ACHIEVEMENT_1_7_DESC"	"Voltooi Rexaura."
"[english]NEW_ACHIEVEMENT_1_7_DESC"	"Complete Rexaura."
"NEW_ACHIEVEMENT_1_8_NAME"	"Kleine longexplosies"
"[english]NEW_ACHIEVEMENT_1_8_NAME"	"Minor Lung Explosions"
"NEW_ACHIEVEMENT_1_8_DESC"	"Word gedood door positron-energiebol van 1600 megawatt."
"[english]NEW_ACHIEVEMENT_1_8_DESC"	"Be killed by a 1600 megawatt positron energy orb."
}
}
